#############B######
##### #### ## ######
##### #### ## ######
##### #### ## ######
##### #### ## ######
##### #### ## ######
##### #### ## ######
##### #### ## ######
#####         ######
#########A##########